Alignment/&ChaoticEvilDescription	Le creature caotico malvage (CM) agiscono con violenza arbitraria, spinte dalla loro avidità, odio o sete di sangue. Demoni, draghi rossi e orchi sono caotici malvagi.
Alignment/&ChaoticEvilTitle	Caotico malvagio
Alignment/&ChaoticEvilTitleShort	CM
Alignment/&ChaoticGoodDescription	Le creature caotico buone (CB) agiscono secondo le direttive della loro coscienza, con scarso riguardo per ciò che gli altri si aspettano. Draghi di rame, molti elfi e unicorni sono caotici buoni.
Alignment/&ChaoticGoodTitle	Caotico Buono
Alignment/&ChaoticGoodTitleShort	CB
Alignment/&ChaoticNeutralDescription	Le creature caotiche neutreli (CN) seguono i loro capricci, mantenendo la loro libertà personale sopra ogni altra cosa. Molti barbari e ladri e alcuni bardi sono caotici neutrali.
Alignment/&ChaoticNeutralTitle	Caotico Neutrale
Alignment/&ChaoticNeutralTitleShort	CN
Alignment/&LawfulEvilDescription	Le creature legali malvagie (LM) prendono metodicamente ciò che vogliono, entro i limiti di un codice di tradizione, lealtà o ordine. I diavoli, i draghi blu e gli hobgoblin sono malvagi legali.
Alignment/&LawfulEvilTitle	Legale male
Alignment/&LawfulEvilTitleShort	LM
Alignment/&LawfulGoodDescription	Si può fare affidamento sulle creature legali buone (LB) per fare la cosa giusta come previsto dalla società. I draghi d'oro, i paladini e la maggior parte dei nani sono legali buoni.
Alignment/&LawfulGoodTitle	Legale buono
Alignment/&LawfulGoodTitleShort	LB
Alignment/&LawfulNeutralDescription	Le persone legali neutrali (LN) agiscono in conformità con la legge, la tradizione o i codici personali. Molti monaci e alcuni maghi sono legittimamente neutrali.
Alignment/&LawfulNeutralTitle	Legale neutrale
Alignment/&LawfulNeutralTitleShort	LN
Alignment/&NeutralDescription	Neutrale Puro (N) è l'allineamento di coloro che preferiscono stare alla larga dalle questioni morali e non prendere posizione, facendo ciò che sembra meglio al momento. I lucertola, la maggior parte dei druidi e molti umani sono neutrali.
Alignment/&NeutralEvilDescription	Neutrale malvagio (NM) è l'allineamento di coloro che fanno tutto ciò con cui riescono a farla franca, senza compassione o scrupoli. Molti drow, alcuni giganti delle nuvole e yugoloth sono malvagi neutrali.
Alignment/&NeutralEvilTitle	Neutrale Malvagio
Alignment/&NeutralEvilTitleShort	NM
Alignment/&NeutralGoodDescription	Le persone neutrali buone (NG) fanno del loro meglio per aiutare gli altri in base alle loro esigenze. Molti celestiali, alcuni giganti delle nuvole e la maggior parte degli gnomi sono buoni neutrali
Alignment/&NeutralGoodTitle	Neutrale Buono
Alignment/&NeutralGoodTitleShort	NG
Alignment/&NeutralTitle	Neutrale
Alignment/&NeutralTitleShort	N
Alignment/&UnalignedDescription	La maggior parte delle creature prive della capacità di pensiero razionale non hanno allineamenti ... sono disallineate. Una tale creatura è incapace di fare una scelta morale o etica e agisce secondo la sua natura bestiale. Gli squali sono predatori selvaggi, per esempio, ma non sono malvagi; non hanno allineamento.
Alignment/&UnalignedTitle	Senza Allineamento
Alignment/&UnalignedTitleShort	SA
