BodyColor/&EyesBlackTitle	Nero
BodyColor/&EyesBlueTitle	Blu
BodyColor/&EyesBrownTitle	Marrone
BodyColor/&EyesGoldenTitle	D'oro
BodyColor/&EyesGreenTitle	verde
BodyColor/&EyesHazelTitle	nocciola
BodyColor/&EyesLavenderTitle	Lavanda
BodyColor/&EyesRedTitle	Rosso
BodyColor/&EyesSilverTitle	Argento
BodyColor/&HairBlackTitle	Nero
BodyColor/&HairBlondTitle	Biondo
BodyColor/&HairBlueTitle	Blu
BodyColor/&HairBrownTitle	Marrone
BodyColor/&HairCopperTitle	Rame
BodyColor/&HairOliveTitle	Oliva
BodyColor/&HairRedTitle	Rosso
BodyColor/&HairRoseTitle	Rosa
BodyColor/&HairSandyBrownTitle	Sabbia
BodyColor/&HairSilverTitle	Argento
BodyColor/&HairWhiteTitle	Bianca
BodyColor/&SkinAlabasterBlueTitle	Blu alabastro
BodyColor/&SkinBronzeTitle	Bronzo
BodyColor/&SkinCopperishTitle	Ramato
BodyColor/&SkinFairTitle	Giusto
BodyColor/&SkinObsidianTitle	Ossidiana
BodyColor/&SkinPaleTitle	Pallido
BodyColor/&SkinTanTitle	Tan
