Caption/&JumpFromCaption	Seleziona un punto da cui saltare.
Caption/&JumpToCaption	Seleziona un punto su cui saltare.
Caption/&LandingPositionCaption	Seleziona un luogo su cui arrampicarti.
Caption/&LevitateDestinationCaption	Seleziona una destinazione di levitazione per il tuo obiettivo.
Caption/&OutOfRangeCaption	Sei fuori portata!
Caption/&ProxyActionTitle	Controllo degli effetti magici
Caption/&ProxyAttackCaption	Seleziona un bersaglio da attaccare con l'effetto magico.
Caption/&ProxyMoveAndAttackCaption	Seleziona la destinazione per spostare l'effetto magico o un bersaglio da attaccare.
Caption/&ProxyMoveCaption	Seleziona una destinazione per spostare l'effetto magico.
Caption/&SelectPositionMultipleCaption	Seleziona {0} posizioni
Caption/&SelectPositionSingleCaption	Seleziona una posizione
Caption/&ShapeConeDirectionCaption	Seleziona una direzione per il cono di effetto.
Caption/&ShapeCubePositionCaption	Seleziona una posizione per il cubo di effetto.
Caption/&ShapeCylinderPositionCaption	Seleziona una posizione per il cilindro dell'effetto.
Caption/&ShapeLineDirectionCaption	Seleziona una direzione per la linea di effetto.
Caption/&ShapeSpherePositionCaption	Seleziona una posizione per la sfera di effetto.
Caption/&ShapeWallLineExtremityCaption	Seleziona un'estremità per l'effetto muro.
Caption/&ShapeWallLineInvalid	La linea di effetto non può essere posizionata qui.
Caption/&ShapeWallLineOriginCaption	Seleziona un'origine per l'effetto muro.
Caption/&ShapeWallLineOutOfLengthCaption	La linea di effetto è troppo lunga!
Caption/&ShapeWallRingPositionCaption	Seleziona una posizione per il cerchio di effetto.
Caption/&ShoveSelectDestinationCaption	Spingere indietro la creatura o abbatterla?
Caption/&ShoveSelectTargetCaption	Seleziona un bersaglio da spingere.
Caption/&ShoveTargetCannotPushAwayCaption	Non c'è spazio per allontanare il bersaglio.
Caption/&ShoveTargetImmuneCaption	Il bersaglio è immune agli spintoni.
Caption/&ShoveTargetOutOfReachCaption	L'obiettivo è fuori portata.
Caption/&ShoveTargetProneCaption	Non puoi spingere un bersaglio prono!
Caption/&ShoveTargetTooBigCaption	Il bersaglio è troppo grande per essere spinto da questa creatura
Caption/&TargetAwakenDescription	Fare clic per risvegliare questo personaggio addormentato.
Caption/&TargetFilteringAllyCreature	Creatura alleata
Caption/&TargetFilteringCreature	Creatura
Caption/&TargetFilteringEffectProxy	Effetto magico
Caption/&TargetFilteringEnemyCreature	Creatura nemica
Caption/&TargetFilteringGadget	Oggetto
Caption/&TargetMultipleCaption	Seleziona {1} target ({0}).\n\n<#B0B0B0>Puoi selezionare ogni target più volte.</color>
Caption/&TargetMultipleUniqueCaption	Seleziona {1} target ({0}).\n<#B0B0B0>Puoi selezionare ciascun target solo una volta.</color>
Caption/&TargetProximityMultipleCaption	<#B0B0B0>I target devono trovarsi entro {0} celle l'uno dall'altro.</color>
Caption/&TargetProximitySingleCaption	<#B0B0B0>I target devono essere uno accanto all'altro.</color>
Caption/&TargetRequiredConditionCaption	<#B0B0B0>Il target deve essere "{0}."</color>
Caption/&TargetRequiredCreatureTypeCaption	<#B0B0B0>I target devono essere {0}
Caption/&TargetRequiredUnarmoredCaption	<#B0B0B0> I bersagli devono essere disarmati.
Caption/&TargetShareUniqueCaption	Seleziona un numero qualsiasi di target ({0}) per condividere l'effetto ({1}).\n\n<#B0B0B0> Puoi selezionare ciascun target solo una volta.</color>
Caption/&TargetSingleCaption	Seleziona un target ({0}).\n
Caption/&TargetStabilizeDescription	Clicca per tentare di stabilizzare questo personaggio morente, con una prova di abilità WIS (Medicina).
Caption/&CannotBePlacedOnCharacterCaption	Non puoi lanciare questo incantesimo direttamente su un personaggio.
Caption/&TargetsMustPerceiveCasterCaption	Gli obiettivi devono percepire la fonte dell'effetto.
Caption/&PositionMustBePerceivedCaption	La posizione non viene percepita.
Caption/&TargetRequiredSizeCaption	La dimensione target deve essere: {0}
Caption/&InviteOptionalAllyCaption	Tocca un alleato opzionale da portare con te.
Caption/&EditorNewPropPlacementCaption	Seleziona una posizione valida per posizionare questo nuovo sostegno\nTieni premuto "Maiusc" per posizionare più oggetti di scena di questo tipo
Caption/&EditorExistingPropPlacementCaption	Seleziona una nuova posizione per questo sostegno
Caption/&EditorNewGadgetPlacementCaption	Seleziona una posizione valida per posizionare questo nuovo gadget\nTieni premuto "Maiusc" per posizionare più gadget di questo tipo
Caption/&EditorExistingGadgetPlacementCaption	Seleziona una nuova posizione per questo gadget
Caption/&EditorSelectedRoomCaption	Stanza selezionata: {0}
Caption/&EditorSelectedPropCaption	Oggetto selezionato: {0}
Caption/&EditorSelectedGadgetCaption	Gadget selezionato: {0}
Caption/&GadgetParametersHeaderTitle	Parametri gadget:
Caption/&GadgetParametersSelectorTitle	Selezionare
Caption/&GadgetParametersSelectorDescription	Fai clic per selezionare un elemento corrispondente (mostro, oggetto, pacchetto bottino) nel database
Caption/&GadgetParametersAddTitle	Aggiungi elemento
Caption/&GadgetParametersAddDescription	Aggiungi un elemento corrispondente (mostro, oggetto, pacchetto bottino) all'elenco
Caption/&GadgetParametersRemoveDescription	Rimuove l'elemento selezionato
Caption/&GadgetParametersNoneTitle	<Vuoto>
Caption/&EditorNewRoomPlacementCaption	Seleziona una posizione valida per posizionare questa nuova stanza\nTieni premuto "Maiusc" per posizionare più stanze di questo tipo
Caption/&EditorExistingRoomPlacementCaption	Seleziona una nuova posizione per questa stanza
Caption/&GadgetParametersLocationSelectorDescription	Fare clic per selezionare una posizione di destinazione da un elenco
