CharacterInteraction/&BanditTrackDescription	Tracce umane - probabilmente banditi. Sembrano piuttosto fresche.
CharacterInteraction/&DisarmTrapDescription	Fare clic per provare a disattivare questa trappola.
CharacterInteraction/&HardClimbDescription	Fare clic per provare a salire.
CharacterInteraction/&LightDescription	Fare clic per accendere questa luce.
CharacterInteraction/&LockPickChestDescription	Fai clic per provare a scassinare il lucchetto su questo forziere.
CharacterInteraction/&LockPickDoorDescription	Fai clic per provare a scassinare la serratura di questa porta.
CharacterInteraction/&LootContainerDescription	Fai clic per saccheggiare questo contenitore.
CharacterInteraction/&NpcInteractionDescription	Fai clic per interagire con questo personaggio.
CharacterInteraction/&ObserveDescription	Fare clic per esaminare questo oggetto.
CharacterInteraction/&OpenCloseDoorDescription	Fare clic per aprire / chiudere questa porta.
CharacterInteraction/&PushDescription	Fare clic per spingere questo oggetto.
CharacterInteraction/&StartLongRestDescription	Fare clic per iniziare una lunga pausa per la festa.
CharacterInteraction/&TriggerTrapDescription	Trigger collasso.
CharacterInteraction/&UseDescription	Fare clic per utilizzare questo oggetto.
CharacterInteraction/&GoblinTrackDescription	Impronte ... Probabilmente quelle dei folletti. Sembrano piuttosto fresche.
CharacterInteraction/&UnknownTrackDescription	Tracce fresche, probabilmente quelle dei fanatici.
CharacterInteraction/&SorakTrackDescription	Tracce di rettili ... Soraks, forse?
CharacterInteraction/&QuickShoppingDescription	Fare clic per aprire il negozio rapido.
CharacterInteraction/&WaitDescription	Fare clic per attendere il sorgere della luna.
CharacterInteraction/&UseScavengersDescription	Fare clic per utilizzare il sistema Scavenger
CharacterInteraction/&TakeScimitarDescription	Clicca per usare la scimitarra e lo scudo per questo combattimento.
CharacterInteraction/&TakeDaggersDescription	Clicca per usare i pugnali per questo combattimento.
CharacterInteraction/&TakeGreataxeDescription	Clicca per usare l'ascia grande per questo combattimento.
CharacterInteraction/&LeaveArenaDescription	Clicca per lasciare l'arena e rinunciare al duello.
CharacterInteraction/&PlantDocumentDescription	Documento dell'impianto
