Encounter/&Abjuration_Caravan_EncounterDescription	Ti sei imbattuto in una carovana, cosa rara in queste terre desolate.
Encounter/&Abjuration_Caravan_EncounterTitle	Incontro inaspettato
Encounter/&Abjuration_Ruins01_EncounterDescription	Mentre viaggiavi attraverso le Badlands verso Coparann, Kythaela ti ha chiesto di fermarti vicino a una vecchia rovina ...
Encounter/&Abjuration_Ruins01_EncounterTitle	Ceneri di Manacalon
Encounter/&Abjuration_Ruins02_EncounterDescription	Kythaela si fermò di nuovo e chiese di entrare in quella che sembra essere una vecchia prigione imperiale.
Encounter/&Abjuration_Ruins02_EncounterTitle	Dungeons di Manacalon
Encounter/&BadlandsSpidersEncounterDescription	Devi aver vagato vicino a un nido: un pugno di questi piccoli mostri ti vuole morto.
Encounter/&BadlandsSpidersEncounterTitle	Ragni delle Badlands
Encounter/&BanditsEncounterDescription	Ladri in cerca di facili prede, preferibilmente ricchi.
Encounter/&BanditsEncounterTitle	Banditi
Encounter/&CrownAttunementEncounterDescription	Il tuo gruppo è costretto a fermarsi per un breve riposo non pianificato. Qualcosa è sbagliato.
Encounter/&CrownAttunementEncounterTitle	Una notte travagliata
Encounter/&DeepSpidersEncounterTitle	Ragni delle profondità
Encounter/&EagleNestEncounterDescription	Ti sei avvicinato troppo a un nido! Le aquile combatteranno fino alla morte per proteggere i loro piccoli!
Encounter/&EagleNestEncounterTitle	Nido delle Aquile
Encounter/&FlyingSnakesEncounterDescription	Uno stuolo di serpenti volanti che ti vogliono lontano dalle loro uova.
Encounter/&FlyingSnakesEncounterTitle	Serpenti Volanti
Encounter/&GoblinCrusadersDescription	Uno sciamano goblin e i suoi seguaci in cerca di gloria.
Encounter/&GoblinCrusadersTitle	Crociata dei Goblin
Encounter/&GoblinhuntingpartyEncounterDescription	Goblin a caccia con i loro lupi addomesticati.
Encounter/&GoblinhuntingpartyEncounterTitle	Gruppo di Goblin Cacciatori
Encounter/&GoblinWarPartyDescription	Una banda di schermagliatori goblin in cerca di guai.
Encounter/&GoblinWarPartyTitle	Gruppo di Goblin da guerra
Encounter/&OrcMaraudersTitle	Predoni Orchi
Encounter/&OrcRaidersDescription	Un capo orco che guida una banda di guerrieri in cerca di cicatrici e gloria.
Encounter/&OrcRaidersTitle	Raziatori Orchi
Encounter/&WinterWolfpackEncounterDescription	Un terribile lupo invernale, a caccia con pochi lupi normali.
Encounter/&WinterWolfpackEncounterTitle	Lupo d'inverno con branco
Encounter/&WolfpackEncounterDescription	Un branco di lupi famelici, alla disperata ricerca di un'uccisione.
Encounter/&WolfpackEncounterTitle	Branco di Lupi
Encounter/&DeepSpidersEncounterDescription	Un enorme gruppo di ragni profondi che cercano di nutrire i loro ragni.
Encounter/&DeathGangTitle	Banda di non morti
Encounter/&DeathGangDescription	Scheletri vaganti, fuggiti da qualche tomba profanata.
Encounter/&DeathSquadTitle	Squadra di non morti
Encounter/&RoamingFanaticsTitle	Fanatici
Encounter/&RoamingFanaticsDescription	Un paio di accoliti guidati da un leader carismatico.
Encounter/&ApprenticeNecromancerTitle	Apprendista Negromante
Encounter/&ApprenticeNecromancerDescription	Uno studente di magia con un mucchio delle sue creazioni in decomposizione.
Encounter/&SpiesOnTheRunTitle	Spie in fuga
Encounter/&SpiesOnTheRunDescription	Un paio di spie che cercano di sfuggire all'intelligence nemica ... a tutti i costi.
Encounter/&GlorySeekerTitle	Cercatore di gloria
Encounter/&GlorySeekerDescription	Un soldato veterano che vaga per le strade in cerca di morte sul campo di battaglia.
Encounter/&BerserkerBrothersTitle	Compagni Berserker
Encounter/&BerserkerBrothersDescription	Combattenti che la pensano allo stesso modo in cerca di sangue. Preferibilmente tuo.
Encounter/&StainedHunterTitle	Cacciatore macchiato
Encounter/&StainedHunterDescription	Un vagabondo solitario delle Badlands che è stato corrotto dalla magia caotica.
Encounter/&HungryWolvesTitle	Lupi affamati
Encounter/&HungryWolvesDescription	Un piccolo branco di lupi, affamati e indeboliti.
Encounter/&GoblinScoutsTitle	Goblin Scout
Encounter/&GoblinScoutsDescription	Un piccolo gruppo di goblin con il loro lupo domestico.
Encounter/&LoneOgreTitle	Orco solitario
Encounter/&LoneOgreDescription	Un orco errante, probabilmente smarrito e decisamente alla ricerca di qualcosa - o qualcuno - da mangiare.
Encounter/&OrcBandTitle	Banda degli Orchi
Encounter/&OrcBandDescription	Un piccolo gruppo di orchi, alla ricerca di qualcosa da uccidere.
Encounter/&RoamingUndeadsTitle	Pattugli di Non morti 
Encounter/&RoamingUndeadsDescription	Un gruppo di non morti, che vaga e cerca di porre fine a qualche vita.
Encounter/&EvilEvangelistsTitle	Evangelisti malvagi
Encounter/&EvilEvangelistsDescription	Un chierico e i suoi scagnozzi, che vagano per la terra per diffondere il loro culto malvagio.
Encounter/&GhoulCoupleTitle	Ghoul
Encounter/&GhoulCoupleDescription	Una banda di demoni con una fame malvagia.
Encounter/&GiantEaglesTitle	Aquile giganti
Encounter/&GiantEaglesDescription	Un paio di aquile giganti che sembrano minacciate dalla tua presenza.
Encounter/&WolfSquadTitle	Squadra di Goblin sui lupi
Encounter/&WolfSquadDescription	Un gruppo di goblin guidati da un Beastmaster e dal suo terribile lupo.
Encounter/&EscapedMinotaurTitle	Minotauro fuggito
Encounter/&EscapedMinotaurDescription	Una creatura rara su Solasta, questa aberrazione guardiana è in una follia omicida.
Encounter/&LoneWightTitle	Wight
Encounter/&LoneWightDescription	Un solitario vagabondo alla ricerca di qualcuno da uccidere.
Encounter/&ScoutingPartyTitle	Scout e lupo
Encounter/&ScoutingPartyDescription	Un subdolo esploratore e il suo lupo domestico.
Encounter/&DireWolfPackTitle	Branco di lupi cruydele
Encounter/&DireWolfPackDescription	Un lupo crudele e il suo branco da caccia.
Encounter/&DireWolfPack2Title	Lupi crudeli
Encounter/&DireWolfPack2Description	Un branco di lupi crudeli.
Encounter/&FanaticDuoTitle	Due Fanatici
Encounter/&FanaticDuoDescription	Una coppia di fanatici in viaggio verso un brutale pellegrinaggio.
Encounter/&MisayeEvangelistsTitle	Evangelista di Misaye
Encounter/&MisayeEvangelistsDescription	Un gruppo di fanatici seguaci di Misaye che hanno le loro interpretazioni del credo della loro divinità.
Encounter/&OgreZombiesTitle	Ogre Zombie
Encounter/&OgreZombiesDescription	Un gruppo di orchi morti trasformati in versioni peggiori di se stessi.
Encounter/&OrcPartyTitle	Gruppo di Orchi da Guerra
Encounter/&OrcPartyDescription	Un gruppo di orchi in cerca di cicatrici e gloria.
Encounter/&WightEscortTitle	Squadra di Wight
Encounter/&WightEscortDescription	Un wight e i suoi soldati a caccia di vivi.
Encounter/&BeastmasterTitle	Beastmaster Ragged
Encounter/&BeastmasterDescription	Un uomo impazzito e i suoi compagni lupi affamati.
Encounter/&GhastsTitle	Ghasts
Encounter/&GhastsDescription	Una banda di ghast in cerca di anime da mietere e corpi da divorare.
Encounter/&GhoulPackTitle	Gruppo di Ghoul
Encounter/&GhoulPackDescription	Un ghast ei suoi demoni alla ricerca di anime da mietere e corpi da divorare.
Encounter/&WolfShamanTitle	Sciamano con lupo
Encounter/&WolfShamanDescription	Uno sciamano goblin e il suo terribile lupo.
Encounter/&OgreBandTitle	Banda di orchi
Encounter/&OgreBandDescription	Un gruppo di orchi arrabbiati.
Encounter/&LeatherskinsTitle	Vestitori di Pelle
Encounter/&LeatherskinsDescription	Un gruppo  di goblin accompagnato da un terribile lupo e da un orco.
Encounter/&CultFanaticsTitle	Fanatici del culto
Encounter/&CultFanaticsDescription	Una banda di fanatici impazziti che credono nelle spade più di quanto credono nelle parole.
Encounter/&WinterWolfPackTitle	Barco del lupo invernale
Encounter/&WinterWolfPackDescription	Un branco guidato da un mostruoso lupo invernale.
Encounter/&ZombiePartyTitle	Zombi
Encounter/&ZombiePartyDescription	In poche parole, una banda di zombi vagabondi in cerca di carne viva.
Encounter/&SlaversTitle	Schiavisti
Encounter/&SlaversDescription	Fanatici in cerca di prede da schiavizzare.
Encounter/&NecromancerTitle	Squadra del negromante
Encounter/&NecromancerDescription	Un negromante e le sue creazioni sul sentiero di guerra.
Encounter/&Leatherskins2Title	Pelli di pelle
Encounter/&Leatherskins2Description	Una banda di orchi guidati da un orco.
Encounter/&FireNestTitle	Tana dei Ragni di Fuoco
Encounter/&FireNestDescription	Un gruppo di ragni di fuoco che vagano fuori dalla loro zona di comfort.
Encounter/&WarlordTitle	Signore della guerra
Encounter/&WarlordDescription	Un potente signore della guerra e il suo cappellano in cerca di una gloriosa battaglia.
Encounter/&ImperialsTitle	Fuorilegge imperiali
Encounter/&ImperialsDescription	Combattenti del Nuovo Impero che decisero di assumersi la responsabilità di applicare la legge del Vecchio Impero.
Encounter/&MinotaursTitle	Minotauri
Encounter/&MinotaursDescription	Minotauri erranti in cerca di libertà e spargimento di sangue.
Encounter/&ShadowPartyTitle	Gruppo di infiltrati
Encounter/&ShadowPartyDescription	Un gruppo di individui subdoli con grandi abilità e lame affilate.
Encounter/&FallenBeastmasterTitle	Beastmaster Macchiato
Encounter/&FallenBeastmasterDescription	Un ranger che ha trascorso troppo tempo nelle Badlands ed è diventato un mostro in più.
Encounter/&SharpshootersTitle	Squadra tiratori scelti
Encounter/&SharpshootersDescription	Una banda di arcieri letali che cercano di affinare le proprie abilità su bersagli vivi.
Encounter/&ApostatesTitle	Apostati
Encounter/&ApostatesDescription	Una banda di crociati la cui fede è stata persa dopo che la loro è stata corrotta dalla magia malvagia.
Encounter/&OrcConquerorTitle	Orchi Conquistatori
Encounter/&OrcConquerorDescription	Un altro gruppo di orchi guerrieri che cercano di diventare re delle Badlands.
Encounter/&BattleMageTitle	Mago da battaglia
Encounter/&BattleMageDescription	Un potente mago e la sua scorta, alla ricerca di nemici da ridurre in cenere.
Encounter/&WarlordsTitle	Guerrafondaia
Encounter/&WarlordsDescription	Potenti combattenti che cercano qualcosa da uccidere per diventare ancora più esperti.
Encounter/&CultLeaderTitle	Leader del culto
Encounter/&CultLeaderDescription	Un potente chierico con la sua scorta personale, in una missione omicida.
Encounter/&SpectralSpidersTitle	Ragni spettrali
Encounter/&SpectralSpidersDescription	Un gruppo di ragni giganti non morti.
Encounter/&PhaseSpiderTitle	Ragno Fase
Encounter/&PhaseSpiderDescription	Un enorme, cattivo, ragno fase.
Encounter/&PhaseSpidersTitle	Ragni Fase
Encounter/&PhaseSpidersDescription	Un mucchio di enormi, cattivi ragni teletrasportanti.
Encounter/&SpectralHunterTitle	Cacciatore spettrale
Encounter/&SpectralHunterDescription	Un cacciatore di non morti e il suo lupo domestico non morto.
Encounter/&TigerDrakesTitle	Serpenti Volanti
Encounter/&TigerDrakesDescription	Enormi serpenti volanti che assomigliano a piccoli draghi.
